N:map002
T:100
S:15,17
D:0,3,0,0,3,0,3,0,0,0,3,0,3,0,0
D:3,3,0,0,0,0,0,0,0,0,0,0,0,0,0
D:0,0,0,0,0,0,0,3,3,0,0,0,2,0,3
D:0,0,0,3,0,3,0,0,3,0,0,2,0,0,3
D:0,0,2,0,0,0,0,0,0,0,3,0,0,0,0
D:0,2,3,0,0,0,2,0,0,3,0,0,0,0,0
D:0,0,3,0,0,2,0,0,3,0,0,0,3,0,3
D:3,0,0,0,3,3,0,0,0,0,0,0,2,0,0
D:0,0,0,0,3,0,0,3,0,0,3,0,0,0,0
D:0,0,2,0,0,0,0,0,0,3,3,0,0,0,3
D:3,0,3,0,0,0,3,0,0,2,0,0,3,0,0
D:0,0,0,0,0,3,0,0,2,0,0,0,3,2,0
D:0,0,0,0,3,0,0,0,0,0,0,0,2,0,0
D:3,0,0,2,0,0,3,0,0,3,0,3,0,0,0
D:3,0,2,0,0,0,3,3,0,0,0,0,0,0,0
D:0,0,0,0,0,0,0,0,0,0,0,0,0,3,3
D:0,0,3,0,3,0,0,0,3,0,3,0,0,3,0
C:1,8
H:13,8
