N:01_ÇPâÒêÌ
T:120
S:15,17
D:0,0,0,0,0,0,0,0,0,0,0,0,0,0,0
D:0,0,0,0,3,3,3,3,3,3,3,0,0,0,0
D:3,3,0,0,0,0,0,0,0,0,0,0,3,3,3
D:3,0,0,0,0,0,3,3,3,0,0,0,0,0,0
D:3,0,0,3,3,3,0,0,0,3,3,3,0,0,0
D:3,0,0,0,0,0,0,0,0,0,0,0,0,0,0
D:0,0,0,0,0,2,0,0,0,2,0,0,0,0,0
D:0,0,0,3,0,0,0,0,0,0,0,3,0,0,0
D:3,3,3,3,0,0,0,3,0,0,0,3,3,3,3
D:0,0,0,3,0,0,0,0,0,0,0,3,0,0,0
D:0,0,0,0,0,2,0,0,0,2,0,0,0,0,0
D:0,0,0,0,0,0,0,0,0,0,0,0,0,0,3
D:0,0,0,3,3,3,0,0,0,3,3,3,0,0,3
D:0,0,0,0,0,0,3,3,3,0,0,0,0,0,3
D:3,3,3,0,0,0,0,0,0,0,0,0,0,3,3
D:0,0,0,0,3,3,3,3,3,3,3,0,0,0,0
D:0,0,0,0,0,0,0,0,0,0,0,0,0,0,0
C:1,1
H:13,15
