N:04_ÇRà åàíËêÌ
T:135
S:15,17
D:0,0,0,0,0,0,0,0,0,0,0,0,0,0,0
D:0,0,3,3,3,0,3,3,3,0,3,3,3,0,0
D:0,0,0,0,0,0,0,0,0,0,0,0,0,0,0
D:0,0,0,0,0,3,0,0,2,0,0,3,3,3,0
D:0,0,3,0,0,3,0,2,2,0,3,0,0,0,0
D:0,0,3,0,0,3,0,0,2,0,3,3,3,3,0
D:0,0,3,0,0,3,0,0,2,0,3,0,0,3,0
D:0,0,0,3,3,0,0,0,2,0,0,3,3,0,0
D:0,0,0,0,0,0,0,3,0,0,0,0,0,0,0
D:0,0,3,3,0,0,2,0,0,0,3,3,0,0,0
D:0,3,0,0,3,0,2,0,0,3,0,0,3,0,0
D:0,3,3,3,3,0,2,0,0,3,0,0,3,0,0
D:0,0,0,0,3,0,2,2,0,3,0,0,3,0,0
D:0,3,3,3,0,0,2,0,0,3,0,0,0,0,0
D:0,0,0,0,0,0,0,0,0,0,0,0,0,0,0
D:0,0,3,3,3,0,3,3,3,0,3,3,3,0,0
D:0,0,0,0,0,0,0,0,0,0,0,0,0,0,0
C:2,3
H:12,13
