N:05_åàèü
T:140
S:15,17
D:0,0,0,0,0,0,0,0,0,0,0,0,0,0,0
D:0,3,0,3,0,0,3,3,3,0,0,3,0,3,0
D:0,0,3,3,0,0,3,2,3,0,0,3,3,0,0
D:0,3,3,0,0,0,0,0,0,0,0,0,3,3,0
D:0,3,0,0,0,0,0,0,0,0,0,0,0,3,0
D:0,0,0,0,0,3,3,3,3,3,0,0,0,0,0
D:0,0,0,0,0,3,2,2,2,3,0,0,0,0,0
D:0,3,3,3,0,0,0,0,0,0,0,3,3,3,0
D:0,3,2,3,0,0,0,3,0,0,0,3,2,3,0
D:0,3,3,3,0,0,0,0,0,0,0,3,3,3,0
D:0,0,0,0,0,3,2,2,2,3,0,0,0,0,0
D:0,0,0,0,0,3,3,3,3,3,0,0,0,0,0
D:0,3,0,0,0,0,0,0,0,0,0,0,0,3,0
D:0,3,3,0,0,0,0,0,0,0,0,0,3,3,0
D:0,0,3,3,0,0,3,2,3,0,0,3,3,0,0
D:0,3,0,3,0,0,3,3,3,0,0,3,0,3,0
D:0,0,0,0,0,0,0,0,0,0,0,0,0,0,0
C:0,8
H:14,8
