N:10_—\”õ
T:130
S:15,17
D:0,0,0,0,0,0,0,0,0,0,0,0,0,0,0
D:0,3,0,3,2,3,0,0,0,3,0,3,0,3,0
D:0,0,0,0,2,0,0,0,0,0,0,0,0,0,0
D:0,3,0,3,2,3,0,3,0,3,0,3,0,3,0
D:0,0,0,0,0,0,0,0,0,0,0,0,0,0,0
D:0,3,0,3,0,3,0,3,0,3,0,3,0,3,0
D:0,0,0,0,0,0,0,0,0,0,0,0,0,0,0
D:0,3,0,3,0,0,0,0,0,0,0,3,0,3,0
D:0,2,2,2,2,0,0,3,0,0,2,2,2,2,0
D:0,3,0,3,0,0,0,0,0,0,0,3,0,3,0
D:0,0,0,0,0,0,0,0,0,0,0,0,0,0,0
D:0,3,0,3,0,3,0,3,0,3,0,3,0,3,0
D:0,0,0,0,0,0,0,0,0,0,0,0,0,0,0
D:0,3,0,3,0,3,0,3,0,3,2,3,0,3,0
D:0,0,0,0,0,0,0,0,0,0,2,0,0,0,0
D:0,3,0,3,0,3,0,0,0,3,2,3,0,3,0
D:0,0,0,0,0,0,0,0,0,0,0,0,0,0,0
C:7,1
H:7,15
